######
#...p#
#Wgp.#
#....#
#H.p.#
######